[
  {
    "nombre":"Laberinto",
    "imgRoute":"img/mapa/Laberinto.png",
    "distribucion":[ 
[1,1,1,1,1,1,1,1,1,2,1,1,1,1,1,1,1,1,1,1,1,1,1,1,1,1,1,1,1,1,1,1,1,1,1,1,1,1,1,1,1,1,1,1,1,1,1,1],
[1,1,19,1,4,1,7,8,1,2,1,1,7,8,1,1,1,1,1,1,1,1,1,1,1,1,1,1,1,1,1,1,7,8,1,1,1,1,1,1,1,1,1,1,7,8,1,1],
[3,3,3,3,3,1,1,1,1,2,1,1,1,1,1,1,1,19,1,1,4,1,1,1,21,1,1,1,1,1,1,1,1,1,1,19,1,1,1,21,1,1,1,1,1,1,1,1],
[1,1,1,1,1,3,1,1,1,2,1,1,1,1,1,1,3,3,3,3,3,6,6,3,3,3,6,6,3,3,3,6,6,3,3,3,6,6,3,3,3,6,6,3,3,3,1,1],
[1,1,1,1,1,1,3,1,1,2,1,1,1,1,1,3,2,1,1,1,1,3,3,1,1,1,3,3,1,1,1,3,3,1,1,1,3,3,1,1,1,3,3,1,1,1,1,1],
[1,1,4,1,1,1,1,1,1,2,1,1,1,1,3,1,2,1,1,1,1,1,1,1,1,1,1,1,1,1,1,1,1,1,1,1,1,1,1,1,1,1,1,1,1,1,1,3],
[1,1,3,3,1,1,1,1,1,2,1,1,1,3,1,1,2,1,1,7,8,1,1,1,1,1,1,1,1,1,1,1,1,1,1,1,1,1,1,1,1,1,1,1,1,1,3,2],
[1,1,1,1,3,1,19,1,1,2,3,1,1,1,1,1,2,1,1,1,1,1,1,4,1,19,1,1,1,1,1,1,1,1,1,1,19,1,1,1,1,21,1,4,1,3,2,2],
[1,1,1,1,1,3,3,1,3,2,2,3,1,1,1,1,2,1,1,1,1,1,1,3,3,3,3,3,6,6,3,3,3,6,6,3,3,3,6,6,3,3,3,3,3,2,2,2],
[3,6,1,1,1,1,2,6,2,2,2,2,3,1,1,1,2,1,1,1,1,1,3,2,1,2,2,2,3,3,2,1,1,3,3,2,2,1,3,3,2,2,2,2,2,2,2,1],
[2,3,3,1,1,1,1,2,2,2,1,1,1,1,1,3,2,1,1,1,1,3,2,1,1,1,1,2,2,1,1,1,1,1,2,2,1,1,1,1,1,1,1,2,2,1,1,1],
[2,2,2,3,1,1,1,1,2,1,1,1,1,1,3,2,2,1,1,1,3,2,1,1,1,1,1,1,1,1,1,7,8,1,1,1,1,1,1,7,8,1,1,1,1,1,1,1],
[3,3,2,2,3,1,1,1,2,1,1,1,1,3,2,2,2,1,1,3,2,1,1,1,1,1,1,1,1,1,1,1,1,1,1,1,1,1,1,1,1,1,1,1,1,1,1,1],
[2,2,2,2,2,3,1,1,2,1,1,1,3,2,2,2,2,1,1,1,1,1,1,1,1,1,1,1,1,4,1,1,1,1,1,1,1,1,1,1,1,1,1,1,4,1,1,1],
[2,2,1,1,1,1,1,1,2,3,1,1,1,1,1,2,2,1,1,1,7,8,1,1,1,1,3,3,3,3,3,6,6,3,6,6,3,6,6,3,6,6,3,3,3,1,1,1],
[1,1,1,1,1,1,1,3,2,2,3,1,1,1,1,2,2,1,1,1,1,1,1,1,1,3,2,2,2,2,2,3,3,2,3,3,2,3,3,2,3,3,1,1,1,1,1,1],
[1,1,1,1,1,1,3,2,2,2,2,3,1,1,1,2,2,1,1,1,1,1,1,1,3,2,1,1,1,1,1,1,1,1,1,1,1,1,1,1,1,1,1,1,1,1,1,3],
[1,1,1,1,1,3,2,2,2,2,1,1,1,1,3,2,2,1,1,1,1,1,1,3,2,1,1,1,1,1,1,1,1,1,1,1,1,1,1,1,1,1,1,1,1,1,3,2],
[20,1,1,1,3,2,2,2,2,1,1,1,1,3,2,2,2,1,1,1,1,1,3,2,1,1,1,1,1,1,1,1,1,1,1,1,1,1,20,1,1,1,1,1,1,1,2,2],
[3,1,1,3,2,2,2,2,1,1,1,1,3,2,2,2,2,1,1,3,3,3,2,1,1,1,1,3,3,3,6,6,3,3,6,6,3,3,3,3,3,6,6,3,1,1,2,2],
[2,1,1,1,1,1,1,1,1,1,1,3,2,3,3,2,2,6,6,2,2,2,1,1,1,1,3,2,1,1,3,3,2,2,3,3,1,1,1,1,1,3,3,2,3,3,2,2],
[2,1,4,1,1,7,8,1,1,1,3,2,2,2,2,2,2,3,3,2,1,1,1,1,1,3,1,1,1,1,1,1,1,1,1,1,1,1,1,1,1,1,1,1,1,1,1,1],
[2,3,3,1,1,1,1,1,1,3,2,2,2,2,2,2,2,1,1,1,1,1,1,1,3,1,1,1,1,1,1,1,1,1,1,1,1,1,1,1,1,1,1,1,7,8,1,1],
[3,2,2,3,1,1,1,1,3,2,2,3,3,3,2,2,2,1,1,1,1,1,1,1,1,1,1,1,1,4,1,1,1,1,1,1,1,1,1,1,1,1,1,1,1,1,1,1],
[2,3,2,2,3,1,1,3,2,2,2,2,2,2,2,2,2,18,1,21,1,1,1,20,1,1,1,1,3,3,3,3,6,6,3,6,6,3,3,6,6,3,3,1,1,1,11,1],
[2,2,2,2,2,6,6,2,2,3,3,3,2,2,2,2,2,3,3,3,3,3,3,3,3,3,3,3,2,2,2,2,3,3,3,3,3,2,2,3,3,2,2,3,3,3,3,3],
[2,2,2,2,2,3,3,2,2,2,2,2,2,2,2,2,2,2,2,2,2,2,2,2,2,2,2,2,2,2,2,2,2,2,2,2,2,2,2,2,2,2,2,2,2,2,2,2]
]
  },
{
    "nombre":"Saltos",
    "imgRoute":"img/mapa/Saltos.png",
    "distribucion":[ 
[1,1,1,1,1,1,1,1,1,1,1,1,1,1,1,1,1,1,1,1,1,1,1,1,1,1,1,1,1,1,1,1,1,1,1,1,1,1,1,1,1,1,1,1,1,1,1,1],
[1,1,21,1,1,1,1,1,1,1,1,1,1,19,1,1,1,1,1,1,1,1,1,1,1,1,1,1,1,1,1,1,1,19,1,1,1,1,1,1,1,1,1,1,1,1,1,1],
[3,3,3,3,1,1,1,1,1,1,1,1,1,14,15,1,1,14,15,1,1,14,15,1,1,14,15,1,1,14,15,1,1,14,15,1,1,14,15,1,1,1,1,1,1,1,1,1],
[2,2,2,2,3,1,1,1,1,1,1,1,1,1,1,1,1,1,1,1,1,1,1,1,1,1,1,1,1,1,1,1,1,1,1,1,1,1,1,1,1,1,1,1,1,1,1,1],
[2,2,2,2,2,3,20,1,4,1,17,1,1,1,1,1,1,1,1,1,1,1,1,1,1,1,1,1,1,1,1,1,1,1,1,1,1,1,1,1,1,21,1,19,1,1,1,1],
[2,2,2,2,2,2,3,3,3,3,3,6,6,6,6,6,6,6,6,6,6,6,6,6,6,6,6,6,6,6,6,6,6,6,6,6,6,6,6,6,3,3,3,3,1,1,1,1],
[2,2,2,2,2,2,2,2,2,2,2,3,3,3,3,3,3,3,3,3,3,3,3,3,3,3,3,3,3,3,3,3,3,3,3,3,3,3,3,3,1,1,1,1,1,1,1,1],
[2,2,2,2,2,1,1,1,1,1,1,1,1,1,1,1,1,1,1,1,1,1,1,1,1,1,1,1,1,1,1,1,1,1,1,1,1,1,1,1,1,1,1,1,1,1,1,3],
[2,2,2,1,1,1,1,1,1,1,1,1,1,1,1,1,1,1,1,1,1,1,1,1,1,1,1,1,1,1,1,1,1,1,1,1,1,1,1,1,1,1,1,1,1,19,3,2],
[2,2,1,1,1,1,1,1,1,1,1,1,1,1,1,1,1,1,1,1,1,1,1,1,1,1,1,1,1,1,1,1,1,1,1,1,1,1,1,1,1,1,1,1,1,3,2,2],
[2,2,1,1,1,1,1,19,1,1,1,1,1,1,1,14,15,1,1,1,1,1,1,1,1,1,14,15,1,1,1,1,1,1,1,1,1,14,15,1,1,1,1,1,3,2,2,2],
[1,1,1,1,1,1,3,3,1,1,1,19,1,1,1,1,1,1,1,1,20,1,1,1,1,1,1,1,1,1,19,1,20,1,1,1,1,1,1,1,1,1,1,3,2,2,2,2],
[1,1,1,1,1,3,2,2,3,3,3,3,16,16,16,16,16,16,3,3,3,3,3,16,16,16,16,16,16,16,3,3,3,3,3,16,16,16,16,16,16,3,3,2,2,2,2,2],
[1,1,1,1,3,2,2,2,1,1,1,1,3,3,3,3,3,3,1,1,1,1,1,3,3,3,3,3,3,3,1,1,1,1,1,3,3,3,3,3,3,2,2,2,2,2,2,2],
[1,1,1,3,2,2,2,1,1,1,1,1,1,1,1,1,1,1,1,1,1,1,1,1,1,1,1,1,1,1,1,1,1,1,1,1,1,1,1,1,1,1,1,2,2,2,2,2],
[21,1,1,1,1,1,1,1,1,1,1,1,1,1,1,1,1,1,1,1,1,1,1,1,1,1,1,1,1,1,1,1,1,1,1,1,1,1,1,1,1,1,1,1,1,2,2,2],
[3,3,1,1,1,1,1,1,1,1,1,1,1,1,1,1,1,1,1,1,1,1,1,1,1,1,1,1,1,1,1,1,1,1,1,1,1,1,1,1,1,1,1,1,1,1,1,2],
[2,2,3,19,1,1,1,1,1,1,1,14,15,1,1,14,15,1,1,14,15,1,1,14,15,1,1,14,15,1,1,14,15,1,1,14,15,1,1,1,1,1,1,1,1,1,1,1],
[2,2,2,3,1,1,1,1,1,1,1,1,1,1,1,1,1,1,1,1,1,1,1,1,1,1,1,1,1,1,1,1,1,1,1,1,1,1,1,1,1,1,1,1,1,1,1,1],
[2,2,2,2,3,1,4,1,17,1,1,1,1,1,1,1,1,1,1,1,1,1,1,1,1,1,1,1,1,1,1,1,1,1,1,1,1,1,1,1,1,1,1,1,1,1,1,1],
[2,2,2,2,2,3,3,3,3,6,6,6,6,6,6,6,6,6,6,6,6,6,6,6,6,6,6,6,6,6,6,6,6,6,6,6,6,6,6,3,3,3,3,1,1,1,1,1],
[2,1,1,1,1,1,1,1,2,3,3,3,3,3,3,3,3,3,3,3,3,3,3,3,3,3,3,3,3,3,3,3,3,3,3,3,3,3,3,1,1,1,1,1,1,1,1,21],
[1,1,1,1,1,1,1,1,1,1,1,1,1,1,1,1,1,1,1,1,1,1,1,1,1,1,1,1,1,1,1,1,1,1,1,1,1,1,1,1,1,1,1,1,1,1,1,3],
[1,1,1,1,1,1,1,1,1,1,1,1,1,1,1,1,1,1,1,1,1,1,1,1,1,1,1,1,1,1,1,1,1,1,1,1,1,1,1,1,1,1,1,1,1,19,3,2],
[1,21,1,11,1,1,1,1,1,1,1,1,1,19,1,1,1,1,1,1,1,19,1,1,1,1,1,1,1,19,1,1,1,1,1,1,1,19,1,1,1,1,4,1,1,3,2,2],
[3,3,3,3,3,3,3,6,6,3,3,6,6,3,3,6,6,3,3,6,6,3,3,6,6,3,3,6,6,3,3,6,6,3,3,6,6,3,3,6,6,3,3,3,3,2,2,2],
[2,2,2,2,2,2,2,3,3,2,2,3,3,2,2,3,3,2,2,3,3,2,2,3,3,2,2,3,3,2,2,3,3,2,2,3,3,2,2,3,3,2,2,2,2,2,2,2]
]
  },
{
    "nombre":"Pasarelas",
    "imgRoute":"img/mapa/Pasarelas.png",
    "distribucion":[ 
[1,1,1,1,1,1,1,1,1,1,1,1,1,1,1,1,1,1,1,1,1,1,1,1,1,1,1,1,1,1,1,1,1,1,1,1,1,1,2,2,1,1,1,1,1,1,1,1],
[1,1,1,1,1,1,1,19,1,1,1,1,1,1,1,1,1,1,1,1,1,1,1,1,1,1,1,1,1,1,1,1,1,1,1,1,1,1,2,2,1,1,1,1,1,1,1,1],
[1,1,1,4,1,1,1,2,1,1,1,1,1,1,1,1,1,1,1,1,1,4,1,1,1,1,1,1,1,1,1,1,1,1,1,1,1,1,2,2,1,1,1,1,1,4,1,1],
[3,3,3,3,1,1,1,2,1,1,1,1,1,3,13,13,13,13,13,13,13,3,1,1,1,1,1,1,1,1,1,1,1,1,1,1,3,1,2,2,1,1,1,1,1,3,1,1],
[2,2,2,1,1,1,1,2,1,1,3,3,3,1,1,1,1,1,1,1,1,2,6,1,1,1,1,1,1,1,1,1,1,1,1,3,2,1,2,2,13,13,13,1,1,2,1,1],
[2,2,2,1,1,1,1,2,1,1,1,1,1,1,1,1,1,1,1,1,1,2,2,6,1,1,1,1,1,1,1,1,1,1,3,2,2,1,2,2,1,1,1,1,1,2,1,6],
[2,2,2,1,1,1,1,2,1,1,1,1,1,1,1,1,1,1,1,1,1,2,2,2,6,1,1,1,1,1,1,1,1,3,2,2,2,1,1,1,1,1,1,1,17,2,1,3],
[1,1,2,2,1,1,1,2,17,1,1,1,1,1,1,1,1,1,1,1,1,2,2,2,2,1,1,1,1,1,1,1,3,2,2,2,2,1,1,1,1,1,1,6,2,2,1,1],
[1,1,18,2,1,1,1,2,13,1,1,1,1,1,1,1,1,1,1,1,1,2,2,2,2,3,3,3,3,3,3,3,2,2,2,2,2,4,1,1,1,17,6,2,2,2,1,1],
[18,18,2,2,1,1,1,2,1,1,1,1,1,1,1,1,1,1,1,1,1,2,1,1,1,1,1,1,1,1,1,1,1,1,1,1,2,3,3,3,3,3,2,2,2,2,1,1],
[2,2,2,2,1,1,1,2,1,1,1,1,1,1,1,1,1,1,1,1,1,1,1,1,1,1,1,1,1,1,1,1,1,1,1,1,1,1,1,1,1,1,1,1,1,2,1,1],
[2,2,2,2,1,1,1,2,1,1,1,1,1,1,1,1,1,1,1,1,1,1,1,1,1,1,1,1,1,1,1,1,1,1,1,1,1,1,1,1,1,1,1,1,1,2,1,1],
[2,2,2,2,1,1,1,2,17,1,1,1,1,1,1,1,1,1,1,1,1,1,1,1,1,1,1,1,1,1,1,1,1,1,1,1,1,1,1,1,1,1,1,1,1,2,1,1],
[2,2,2,2,1,1,1,2,2,1,1,1,1,1,1,1,1,1,1,1,1,4,1,1,1,1,1,1,1,1,1,1,1,1,1,1,1,1,1,1,1,1,1,1,1,2,1,1],
[2,2,2,2,1,1,1,2,1,1,3,3,3,1,1,3,3,3,1,1,3,3,13,13,13,13,13,13,13,13,13,13,13,13,13,13,13,13,3,1,1,1,1,1,1,2,1,1],
[2,2,2,2,1,1,6,2,1,1,1,1,1,1,1,1,1,1,1,1,1,1,1,1,1,1,1,1,1,1,1,1,1,1,1,1,1,1,2,3,1,1,1,1,1,2,6,1],
[2,2,2,2,1,1,2,2,1,1,1,1,1,1,1,1,1,1,1,1,1,1,1,1,1,1,1,1,1,1,1,1,1,1,1,1,1,1,2,2,3,1,1,1,1,2,3,1],
[2,2,2,2,1,1,1,1,1,1,1,1,1,1,1,1,1,1,1,1,1,1,1,1,1,1,1,1,1,1,1,1,1,1,1,1,1,1,2,18,2,3,1,1,1,2,1,1],
[2,2,2,2,1,1,1,1,1,1,1,1,1,1,1,1,1,1,1,1,1,1,1,1,1,1,1,1,1,1,1,1,1,1,1,1,1,1,2,2,2,2,3,1,1,2,1,1],
[2,2,2,2,1,1,1,4,1,1,1,1,1,1,1,1,1,1,1,1,1,1,1,1,1,1,1,1,1,1,1,1,1,1,1,1,1,1,1,1,1,1,1,1,1,2,1,1],
[2,2,2,2,1,1,1,3,1,1,1,1,1,1,1,1,1,1,1,1,1,4,1,1,13,1,1,13,1,1,13,1,1,1,1,1,1,1,1,1,1,1,1,1,3,2,1,1],
[2,2,2,2,1,1,1,2,1,1,1,1,1,1,1,1,1,1,1,1,13,3,1,1,1,1,1,1,1,1,1,1,1,1,1,1,1,1,1,1,1,1,1,3,1,1,1,1],
[2,2,2,2,1,1,1,2,1,1,1,1,1,1,1,1,1,1,1,1,1,2,1,1,1,1,1,1,1,1,1,1,1,1,1,1,1,1,1,1,1,1,3,1,1,1,1,3],
[2,2,2,2,1,17,1,2,1,1,1,1,1,1,1,1,1,1,1,1,1,2,16,16,16,16,16,16,16,16,16,16,16,16,16,16,16,16,16,16,16,3,2,1,1,1,19,2],
[2,2,2,2,6,2,6,2,6,6,17,6,6,6,17,6,6,6,17,6,6,2,3,3,3,3,3,3,3,3,3,3,3,3,3,3,3,3,3,3,3,2,2,11,1,1,3,2],
[2,2,2,2,2,2,2,2,2,2,2,2,2,2,2,2,2,2,2,2,2,2,2,2,2,2,2,2,2,2,2,2,2,2,2,2,2,2,2,2,2,2,2,3,3,3,2,2],
[2,2,2,2,2,2,2,2,2,2,2,2,2,2,2,2,2,2,2,2,2,2,2,2,2,2,2,2,2,2,2,2,2,2,2,2,2,2,2,2,2,2,2,2,2,2,2,2]
]
  }
]