[
  {
    "nombre":"Laberinto",
    "imgRoute":"img/mapa/Laberinto.png",
    "distribucion":[ 
[1,1,1,1,1,1,1,1,1,2,1,1,1,1,1,1,1,1,1,1,1,1,1,1,1,1,1,1,1,1,1,1,1,1,1,1,1,1,1,1,1,1,1,1,1,1,1,1]
,[1,1,1,1,1,1,7,8,1,2,1,1,7,8,1,1,1,1,1,1,1,1,1,1,1,1,1,1,1,1,1,1,7,8,1,1,1,1,1,1,1,1,1,1,7,8,1,1]
,[1,1,1,1,4,1,1,1,1,2,1,1,1,1,1,1,1,1,1,1,4,1,1,1,1,1,1,1,1,1,1,1,1,1,1,1,1,1,1,1,1,1,1,1,1,1,1,1]
,[3,3,3,3,3,1,1,1,1,2,1,1,1,1,1,1,3,3,3,3,3,6,6,3,3,3,6,6,3,3,3,6,6,3,3,3,6,6,3,3,3,6,6,3,3,3,1,1]
,[1,1,1,1,1,3,1,1,1,2,1,1,1,1,1,3,2,1,1,1,1,3,3,1,1,1,3,3,1,1,1,3,3,1,1,1,3,3,1,1,1,3,3,1,1,1,1,1]
,[1,1,4,1,1,1,3,1,1,2,1,1,1,1,3,1,2,1,1,1,1,1,1,1,1,1,1,1,1,1,1,1,1,1,1,1,1,1,1,1,1,1,1,1,1,1,1,3]
,[1,1,3,3,1,1,1,1,1,2,1,1,1,3,1,1,2,1,1,7,8,1,1,1,4,1,1,1,1,1,1,1,1,1,1,1,1,1,1,1,1,1,1,1,4,1,3,2]
,[1,1,1,1,3,1,1,1,1,2,3,1,1,1,1,1,2,1,1,1,1,1,1,1,3,3,3,6,6,3,3,6,6,3,3,6,6,3,3,3,6,6,3,3,3,3,2,2]
,[1,1,1,1,1,3,3,1,3,2,2,3,1,1,1,1,2,1,1,1,1,1,1,3,2,2,2,3,3,2,2,3,3,2,2,3,3,2,2,2,3,3,2,2,2,2,2,2]
,[3,6,1,1,1,1,2,6,2,2,2,2,3,1,1,1,2,1,1,1,1,1,3,2,1,2,2,2,2,2,2,1,1,2,2,2,2,1,1,2,1,1,2,2,2,2,2,1]
,[2,3,3,1,1,1,1,2,2,2,1,1,1,1,1,3,2,1,1,1,1,3,2,1,1,1,1,2,2,1,1,1,1,1,2,2,1,1,1,1,1,1,1,2,2,1,1,1]
,[2,2,2,3,1,1,1,1,2,1,1,1,1,1,3,2,2,1,1,1,3,2,1,1,1,1,1,1,1,1,1,7,8,1,1,1,1,1,1,7,8,1,1,1,1,1,1,1]
,[3,3,2,2,3,1,1,1,2,1,1,1,1,3,2,2,2,1,1,3,2,1,1,1,1,1,1,1,1,1,1,1,1,1,1,1,1,1,1,1,1,1,1,1,1,1,1,1]
,[2,2,2,2,2,3,1,1,2,1,1,1,3,2,2,2,2,1,1,1,1,1,1,1,1,1,1,1,1,4,1,1,1,1,1,1,1,1,1,1,1,1,1,1,4,1,1,1]
,[2,2,1,1,1,1,1,1,2,3,1,1,1,1,1,2,2,1,1,1,7,8,1,1,1,1,3,3,3,3,3,6,6,3,6,6,3,6,6,3,6,6,3,3,3,1,1,1]
,[1,1,1,1,1,1,1,3,2,2,3,1,1,1,1,2,2,1,1,1,1,1,1,1,1,3,2,2,2,2,2,3,3,2,3,3,2,3,3,2,3,3,1,1,1,1,1,1]
,[1,1,1,1,1,1,3,2,2,2,2,3,1,1,1,2,2,1,1,1,1,1,1,1,3,2,1,1,1,1,1,1,1,1,1,1,1,1,1,1,1,1,1,1,1,1,1,3]
,[1,1,1,1,1,3,2,2,2,2,1,1,1,1,3,2,2,1,1,1,1,1,1,3,2,1,1,1,1,1,1,1,1,1,1,1,1,1,1,1,1,1,1,1,1,1,3,2]
,[1,1,1,1,3,2,2,2,2,1,1,1,1,3,2,2,2,1,1,1,1,1,3,2,1,1,1,1,1,1,1,1,1,1,1,1,1,1,3,3,1,1,1,1,1,1,2,2]
,[3,1,1,3,2,2,2,2,1,1,1,1,3,2,2,2,2,1,1,3,3,3,2,1,1,1,1,3,3,3,6,6,3,3,6,6,3,3,2,2,3,6,6,3,1,1,2,2]
,[2,1,1,1,1,1,1,1,1,1,1,3,2,3,3,2,2,6,6,2,2,2,1,1,1,1,3,2,1,1,3,3,3,1,3,3,1,1,1,1,1,3,3,2,3,3,2,2]
,[2,1,4,1,1,7,8,1,1,1,3,2,2,2,2,2,2,3,3,2,1,1,1,1,1,3,1,1,1,1,1,1,1,1,1,1,1,1,1,1,1,1,1,1,1,1,1,1]
,[2,3,3,1,1,1,1,1,1,3,2,2,2,2,2,2,2,2,1,1,1,1,1,1,3,1,1,1,1,1,1,1,1,1,1,1,1,1,1,1,1,1,1,1,7,8,1,1]
,[3,2,2,3,1,1,1,1,3,2,2,3,3,3,2,2,2,2,1,1,1,1,3,3,1,1,1,1,1,4,1,1,1,1,1,1,1,1,1,1,1,1,1,1,1,1,1,1]
,[2,3,2,2,3,1,1,3,2,2,2,2,2,2,2,2,2,1,1,1,1,1,1,1,1,1,1,1,3,3,3,3,6,6,3,6,6,3,3,6,6,3,3,1,1,1,1,1]
,[2,2,2,2,2,6,6,2,2,3,3,3,2,2,2,2,2,1,1,1,1,1,1,1,1,1,1,3,2,2,2,2,3,3,3,3,3,2,2,3,3,2,2,3,1,1,5,1]
,[2,2,2,2,2,3,3,2,2,2,2,2,2,2,2,2,2,3,3,3,3,3,3,3,3,3,3,2,2,2,2,2,2,2,2,2,2,2,2,2,2,2,2,2,3,3,3,3]
]
  },
{
    "nombre":"nieve2",
    "imgRoute":"img/mapa/casillas/Cielo.png",
    "distribucion":[ 
[1,1,1,1,1,1,1,1,1,2,1,1,1,1,1,1,1,1,1,1,1,1,1,1,1,1,1,1,1,1,1,1,1,1,1,1,1,1,1,1,1,1,1,1,1,1,1,1]
,[1,1,1,1,1,1,7,8,1,2,1,1,7,8,1,1,1,1,1,1,1,1,1,1,1,1,1,1,1,1,1,1,7,8,1,1,1,1,1,1,1,1,1,1,7,8,1,1]
,[1,1,1,1,4,1,1,1,1,2,1,1,1,1,1,1,1,1,1,1,4,1,1,1,1,1,1,1,1,1,1,1,1,1,1,1,1,1,1,1,1,1,1,1,1,1,1,1]
,[3,3,3,3,3,1,1,1,1,2,1,1,1,1,1,1,3,3,3,3,3,6,6,3,3,3,6,6,3,3,3,6,6,3,3,3,6,6,3,3,3,6,6,3,3,3,1,1]
,[1,1,1,1,1,3,1,1,1,2,1,1,1,1,1,3,2,1,1,1,1,3,3,1,1,1,3,3,1,1,1,3,3,1,1,1,3,3,1,1,1,3,3,1,1,1,1,1]
,[1,1,4,1,1,1,3,1,1,2,1,1,1,1,3,1,2,1,1,1,1,1,1,1,1,1,1,1,1,1,1,1,1,1,1,1,1,1,1,1,1,1,1,1,1,1,1,3]
,[1,1,3,3,1,1,1,1,1,2,1,1,1,3,1,1,2,1,1,7,8,1,1,1,4,1,1,1,1,1,1,1,1,1,1,1,1,1,1,1,1,1,1,1,4,1,3,2]
,[1,1,1,1,3,1,1,1,1,2,3,1,1,1,1,1,2,1,1,1,1,1,1,1,3,3,3,6,6,3,3,6,6,3,3,6,6,3,3,3,6,6,3,3,3,3,2,2]
,[1,1,1,1,1,3,3,1,3,2,2,3,1,1,1,1,2,1,1,1,1,1,1,3,2,2,2,3,3,2,2,3,3,2,2,3,3,2,2,2,3,3,2,2,2,2,2,2]
,[3,6,1,1,1,1,2,6,2,2,2,2,3,1,1,1,2,1,1,1,1,1,3,2,1,2,2,2,2,2,2,1,1,2,2,2,2,1,1,2,1,1,2,2,2,2,2,1]
,[2,3,3,1,1,1,1,2,2,2,1,1,1,1,1,3,2,1,1,1,1,3,2,1,1,1,1,2,2,1,1,1,1,1,2,2,1,1,1,1,1,1,1,2,2,1,1,1]
,[2,2,2,3,1,1,1,1,2,1,1,1,1,1,3,2,2,1,1,1,3,2,1,1,1,1,1,1,1,1,1,7,8,1,1,1,1,1,1,7,8,1,1,1,1,1,1,1]
,[3,3,2,2,3,1,1,1,2,1,1,1,1,3,2,2,2,1,1,3,2,1,1,1,1,1,1,1,1,1,1,1,1,1,1,1,1,1,1,1,1,1,1,1,1,1,1,1]
,[2,2,2,2,2,3,1,1,2,1,1,1,3,2,2,2,2,1,1,1,1,1,1,1,1,1,1,1,1,4,1,1,1,1,1,1,1,1,1,1,1,1,1,1,4,1,1,1]
,[2,2,1,1,1,1,1,1,2,3,1,1,1,1,1,2,2,1,1,1,7,8,1,1,1,1,3,3,3,3,3,6,6,3,6,6,3,6,6,3,6,6,3,3,3,1,1,1]
,[1,1,1,1,1,1,1,3,2,2,3,1,1,1,1,2,2,1,1,1,1,1,1,1,1,3,2,2,2,2,2,3,3,2,3,3,2,3,3,2,3,3,1,1,1,1,1,1]
,[1,1,1,1,1,1,3,2,2,2,2,3,1,1,1,2,2,1,1,1,1,1,1,1,3,2,1,1,1,1,1,1,1,1,1,1,1,1,1,1,1,1,1,1,1,1,1,3]
,[1,1,1,1,1,3,2,2,2,2,1,1,1,1,3,2,2,1,1,1,1,1,1,3,2,1,1,1,1,1,1,1,1,1,1,1,1,1,1,1,1,1,1,1,1,1,3,2]
,[1,1,1,1,3,2,2,2,2,1,1,1,1,3,2,2,2,1,1,1,1,1,3,2,1,1,1,1,1,1,1,1,1,1,1,1,1,1,3,3,1,1,1,1,1,1,2,2]
,[3,1,1,3,2,2,2,2,1,1,1,1,3,2,2,2,2,1,1,3,3,3,2,1,1,1,1,3,3,3,6,6,3,3,6,6,3,3,2,2,3,6,6,3,1,1,2,2]
,[2,1,1,1,1,1,1,1,1,1,1,3,2,3,3,2,2,6,6,2,2,2,1,1,1,1,3,2,1,1,3,3,3,1,3,3,1,1,1,1,1,3,3,2,3,3,2,2]
,[2,1,4,1,1,7,8,1,1,1,3,2,2,2,2,2,2,3,3,2,1,1,1,1,1,3,1,1,1,1,1,1,1,1,1,1,1,1,1,1,1,1,1,1,1,1,1,1]
,[2,3,3,1,1,1,1,1,1,3,2,2,2,2,2,2,2,2,1,1,1,1,1,1,3,1,1,1,1,1,1,1,1,1,1,1,1,1,1,1,1,1,1,1,7,8,1,1]
,[3,2,2,3,1,1,1,1,3,2,2,3,3,3,2,2,2,2,1,1,1,1,3,3,1,1,1,1,1,4,1,1,1,1,1,1,1,1,1,1,1,1,1,1,1,1,1,1]
,[2,3,2,2,3,1,1,3,2,2,2,2,2,2,2,2,2,1,1,1,1,1,1,1,1,1,1,1,3,3,3,3,6,6,3,6,6,3,3,6,6,3,3,1,1,1,1,1]
,[2,2,2,2,2,6,6,2,2,3,3,3,2,2,2,2,2,1,1,1,1,1,1,1,1,1,1,3,2,2,2,2,3,3,3,3,3,2,2,3,3,2,2,3,1,1,5,1]
,[2,2,2,2,2,3,3,2,2,2,2,2,2,2,2,2,2,3,3,3,3,3,3,3,3,3,3,2,2,2,2,2,2,2,2,2,2,2,2,2,2,2,2,2,3,3,3,3]
]
  }
]